13 15
111111111111111
100000000000001
101111110001101
101111110001101
101111100001101
100000000011101
101111100011101
101111100011101
101111100011101
101111000011101
101111000011111
100000000000001
111111111111111
7
2 14
12 2