***************
*            M*
* ******   ** *
* ******   ** *
* *****    ** *
*         *** *
* *****   *** *
* *****   *** *
* *****   *** *
* ****    *** *
* ****    *****
*C           o*
***************