15 18
111111111111111111
100000000000000001
101111111111111101
101000000000000101
101011111111110101
101010000000010101
101010111111010101
101010100001010101
101010101111010101
101010100000010101
101010101111110101
101010000000000101
101011111111111101
101000000000000001
111111111111111111
10
8 10
14 2