******************
*                *
* ************** *
* *            * *
* * ********** * *
* * *        * * *
* * * ****** * * *
* * *    Co* * * *
* * * * **** * * *
* * * *      * * *
* * * * ****** * *
* * *          * *
* * ************ *
*M*              *
******************