11111111111
100000000M1
10111101101
10111101101
10111001101
10111011101
10111011101
10110011101
10110011101
1C000000001
11111111111
