11 11
11111111111
10000000001
10111101101
10111101101
10111001101
10111011101
10111011101
10110011101
10110011101
10000000001
11111111111
10
2 9
9 1
