***********
*        M*
* **** ** *
* **** ** *
* ***  ** *
* *** *** *
* *** *** *
* **  *** *
* **  *** *
*C o      *
***********